﻿..................................................
..................................................
........#.........................................
........#.........................................
........#.........................................
........#.........................................
........#.........................................
........#......#################..................
........#......................#..................
........#......................#..................
........#......................#..................
........#..........#########...#..................
........#......................#..................
........#......................#..................
........########################..................
...............................#..................
...............................#..................
...............................#..................
...............................#..............#...
.............................................#....
............................................#.....
...........#################################......
..................................................
﻿............##############################........
..................................................
........#.........................................
........#.........................................
........#.........................................
........#.........................................
........#.........................................
﻿........#......#..................................
........#.....#...................................
........#....#....................................
........#...#.....................................
........#..#......................................
........#.#.......................................
........#.........................................
﻿........#.........................................
........#.........................................
........#.........................................
........#####################################.....
........#.........................................
........#.........................................
........#.........................................
﻿..................................................
..................................................
........#.........................................
........#.........................................
........#.........................................
........#.........................................